01000000011
01001110011
01000000000
00000000000
00000000000
00000011000
00100010000
00010000010
01110000110